[General]
Font="Noto Sans"
FontSize=14
ClockEnabled="false"
CustomBackground="true"
LoginBackground="true"
Background="./backgrounds/wallpaper.jpg"
UserIcon="false"
AccentColor="@accent_primary@"

# Uncomment this option to show the last letter of the password
# for the number of milliseconds specified
# PasswordShowLastLetter=1000

# DON'T CHANGE THESE
#I did I hope I don't get any problems
rosewater = "@accent_light@"
flamingo  = "@accent_warning@"
pink      = "@accent_secondary@"
mauve     = "@accent_primary@"
red       = "@error@"
maroon    = "@error_alt@"
peach     = "@warning@"
yellow    = "@attention@"
green     = "@success@"
teal      = "@info@"
sky       = "@accent_info@"
sapphire  = "@accent_hover@"
blue      = "@link@"
lavender  = "@accent_alt@"
text      = "@fg_primary@"
subtext1  = "@fg_secondary@"
subtext0  = "@fg_muted@"
overlay2  = "@fg_overlay_strong@"
overlay1  = "@fg_overlay_medium@"
overlay0  = "@fg_overlay_weak@"
surface2  = "@bg_surface_high@"
surface1  = "@bg_surface_medium@"
surface0  = "@bg_surface_low@"
base      = "@bg_base@"
mantle    = "@bg_subtle@"
crust     = "@bg_deep@"
